11
9
_ _ _ _ _ _ _ _ x
_ x _ _ _ _ _ x _
_ _ x _ _ _ x _ _
_ _ _ x g x _ _ _
_ _ _ _ x _ _ _ _
x x x _ s _ x x x
_ _ _ _ x _ _ _ _
_ _ _ x _ x _ _ _
_ _ x _ _ _ x _ _
_ x _ _ _ _ _ x _
x _ _ _ _ _ _ _ x
