5
5
_ _ _ _	_
_ _ _ _	_
_ _ _ _	_
_ _ x _	_
_ _ s x g
	