10
10
_ _ _ _ _ _ _ _ _ _
_ _ _ _ _ _ _ _ g _
_ _ x _ _ _ _ x _ _
_ _ _ _ _ _ _ _ _ _
_ _ _ _ _ _ _ _ _ _
_ _ _ _ x x _ _ _ _
_ _ _ _ _ _ _ _ _ _
_ _ _ _ _ _ _ _ _ _
_ s x _ _ _ _ x _ _
_ _ _ _ _ _ _ _ _ _