15
15
_ _ _ _ _ _ _ _ _ _ _ _ _ _ _
_ _ _ _ _ _ _ x x x _ _ _ _ _
_ _ _ g _ _ x _ _ _ x _ _ _ _
_ _ _ _ _ x _ _ _ _ _ x _ _ _
_ _ _ _ x _ _ _ x _ _ _ x _ _
_ _ _ x _ _ _ x _ x _ _ _ x _
_ _ _ x _ _ x s _ _ x _ _ _ _
_ _ _ x _ _ x x x _ _ x _ _ _
_ _ _ x _ _ x x x _ _ x _ _ _
_ _ _ x _ _ _ x _ _ _ x _ _ _
_ _ _ _ x _ _ _ _ _ x _ _ _ _
_ _ _ _ _ x _ _ _ x _ _ _ _ _
_ _ _ _ _ _ x x x _ _ _ _ _ _
_ _ _ _ _ _ _ _ _ _ _ _ _ _ _
_ _ _ _ _ _ _ _ _ _ _ _ _ _ _
